111111111111111111111111111111111111111
1                                     1
1 11 11 11 11 11 11 11 11 11 11 11 11 1
1 11 11 11 11 11 11 11 11 11 11 11 11 1
1                                     1
1 11 11 11 11 11 11 11 11 11 11 11 11 1
1 11 11 11 11 11 11 11 11 11 11 11 11 1
1                                     1
1 11 11 11 11 11 11 11 11 11 11 11 11 1
1 11 11 11 11 11 11 11 11 11 11 11 11 1
1                                     1
1 11 11 11 11 11 11 11 11 11 11 11 11 1
1 11 11 11 11 11 11 11 11 11 11 11 11 1
1                  0                  1
1 11 11 11 11 11 11 11 11 11 11 11 11 1
1 11 11 11 11 11 11 11 11 11 11 11 11 1
1                                     1
1 11 11 11 11 11 11 11 11 11 11 11 11 1
1 11 11 11 11 11 11 11 11 11 11 11 11 1
1                                     1
1 11 11 11 11 11 11 11 11 11 11 11 11 1
1 11 11 11 11 11 11 11 11 11 11 11 11 1
1                                     1
111111111111111111111111111111111111111
END