111111111111
1          1
1 111 1111 1
1 111 1111 1
1    s     1
1 111 1111 1
1 111 1111 1
1          1
111111111111
END