111111111111
1          1
1 11111111 1
1 1      1 1
1 1      1 1
1 11111111 1
1    s     1
111111111111
END